11111111111
10CCCCCCCC1
1CCCCCCCCE1
11111111111
11111111111
11111111111
