1111111111111111111111111
1001000000000000000000001
100100001000C000000000001
10010000100001000000C0001
1E01000111111100000000001
1001000000000100000000001
1001000000001111111111C01
100010000C000000011111001
1000010000000000001000001
1000001000111000001000001
10000010010C0100001000001
100C001C000001000010C0001
10000011111111C0001000001
1000000000C00000001000001
1111111111111111111111111
