1111111111111111111111111
1000001000000000000000001
1000001000000000000000001
1000001000000000000000001
1000001111000000000000001
100000000000C000000000001
1000000000000000000000001
1000000001100000000000001
10C0000001100000C00000001
1000000000000000000000001
100000000C000000000000001
1000000000000000000000001
10000000000E0000000000001
1000000000000000000000001
1111111111111111111111111
