111111111111111111111111111111111111111111111111111111
1PE010C01CCCCCCCCCCCCCCCCCCCCCCCCCCCC101000100010001C1
1000100010M0111111111111111111111111C10101010101010101
1000000010M01CCCCCCCCCCCCCCCCCCCCCC1C10001000100010001
1000000010M01C11111111111111111111C1C10111111111111111
1000000010M01C1CCCCCCCCCCCCCCCCCC1C1C10000000000000001
1111110010M01C1C1111111111111111C1C1C11111111111110001
1C00000010M01C1C1CCCCCCCCCCCCCCCC1C1C10000000000010001
1000000010M01C1C111111111111111111C1C10000101111110001
100000C010M01C1CCCCCCCCCCCCCCCCCCCC1C10000100000010001
1000011110M01C1111111111111111111111C10000111111010001
1000000010M01CCCCCCCCCCCCCCCCCCCCCCCC10000100000010001
1000000010M0111111111111111111111111110000101111110001
1C00000010M0000000000000000000000000000000100000010001
1111100010M0000000000000000000000000000000111111010001
100000001000000000000000000000000000000000100000010001
100000001111111111111111111111111111111000101111110001
100011111000000000000000001CCCCCCCCCCC1000100000010001
100010000000000000000000001CCCCCCCCCCC1000111111010001
100010000000000000000000001C11111111111000100000010001
100010001111111100000000001000000000001000101111110001
100010000000000100000000001000000000000000100000010001
1000100C0000000100000000001000000000001000111111010001
1000111000000001000000000010000000000010001CCCCCC10001
100000111111000100000000001111111111111000111111110001
100000000000000100000000000000000000000000000000000001
100000000000000100000000000000000000000000000000000001
100C10000000000100000000000000000000000000000000000001
111111111111111111111111111111111111111111111111111111
