1111111111
1000CEC001
1111111111
