1111111111
1001CEC101
1111111111
