1111111111
1000CE0101
1000C0C101
1111111111
