1111111111111111111111111
100010M0000000M001M1MMM01
10M010001000C00000100M001
1000100010000000000000001
1E0010011111110000M000001
10001000M0000100000000001
100M1M0000001111111111C11
100010000C000000011111001
1000010000000000001000001
10000010001111000010P0001
10000010010C0100001101111
100C001C000001000010C0001
10M00011111111C0M01000001
1000000000C000000010M0001
1111111111111111111111111
