1111111111
1PC0C010E1
1C0010P001
1111111111
